12
12
-  -  -  -  ^  ^  ^  -  -  ^  ^  ^
-  -  -  -  ^  ^  -  -  -  ^  -  ^
-  -  -  -  ^  -  -  -  -  -  -  @
^  t  -  ^  -  -  -  -  -  -  -  -
^  t  ^  ^  ^  -  -  ^  -  ^  -  ^
t  t  ^  t  t  ^  ^  -  ^  -  ^  -
t  t  t  t  t  ^  ^  -  -  -  ^  -
t  t  t  t  w  ^  ^  ^  -  -  -  -
-  ^  t  t  w  ^  t  t  -  ^  ^  -
-  ^  t  t  w  ^  t  t  -  ^  ^  -
t  ^  t  t  w  t  t  t  -  ^  ^  -
@  ^  t  w  w  w  t  t  t  ^  x  -